{"l_1":[["X","X","X","X","X","X","X","X","0","0","0","0","0","0","0","0","0","0","0","0","0","0","0","7","7","7","7","7","0","0","0","0","0","0","0","0","0","0","4","X","4","4","4","4","4","4","4","4","4","4","0","0","0","2","2","2","X","X","X","X","X","X","X","X","X","X","X","X","X","X","X","X","X","X","X","X","X","X","X","X","X","2","2","2","2","4","4","4","4","4","4","4","X","X","X","X","X","X","X","X","X","X","X","X","X","X","2","2","2","0","0","0","0","2","2","4","4","4","0","0","0","0","0","0","0","0","0","0","0","0","0","0","0","0","0","0","0","0","0","0","0","0","0","0","0","0","0","0","0","0","0","0","0","0","0","0","0","0","0","0","0","0","0","0","0","0","0","5","4","4","4","4","2","0","0","0","0","0","0","0","0","0","X","X","X","X","X","X","X","X","X","X","X","X","X"],
["X","X","X","X","X","X","X","X","0","0","0","0","0","0","0","0","0","0","0","0","0","0","0","7","0","0","0","0","0","0","0","0","0","0","0","0","0","0","4","4","4","0","0","0","0","0","4","4","4","0","0","0","0","2","2","2","2","0","0","X","X","X","X","X","X","X","X","X","X","X","X","X","X","X","X","X","X","X","X","X","X","2","0","0","0","0","4","4","4","0","4","4","X","X","X","X","X","X","X","2","2","2","2","2","2","2","2","0","0","0","0","0","0","2","2","4","4","4","0","0","0","0","0","0","0","0","0","0","0","0","0","0","0","0","0","0","0","0","0","0","0","0","0","0","0","0","0","0","0","0","0","0","0","X","0","0","0","0","0","0","0","0","0","0","0","0","0","5","0","0","0","0","2","0","0","0","0","0","0","0","0","0","0","X","X","X","X","X","X","X","X","X","X","X","X"],
["X","X","X","X","X","X","X","X","0","0","0","0","0","0","0","0","0","0","0","0","0","0","0","7","0","0","0","0","0","0","0","4","4","0","0","0","0","0","4","0","0","0","0","0","0","0","4","4","0","0","0","0","0","2","X","0","0","0","0","0","X","X","X","2","X","X","4","4","X","X","X","X","X","X","X","X","X","X","X","X","2","0","0","0","0","0","0","4","0","0","0","4","X","X","X","X","X","X","X","0","0","0","0","0","0","0","0","0","0","0","0","0","0","0","2","4","4","4","0","0","0","0","0","0","0","0","0","0","X","X","X","X","X","X","X","0","0","0","0","0","0","0","0","0","0","0","0","0","3","0","0","0","X","X","0","0","0","0","0","0","0","0","0","0","0","0","0","5","0","0","0","0","2","0","0","0","0","0","0","0","0","0","0","0","0","4","X","X","X","X","X","X","X","X","X"],
["X","X","X","X","X","X","X","X","0","0","0","0","0","0","0","3","3","0","0","0","0","0","0","7","0","0","0","0","0","0","0","4","4","0","0","0","0","0","5","0","0","0","0","0","0","0","0","5","0","0","0","0","0","0","0","0","0","0","0","0","0","X","X","4","4","X","4","4","X","X","X","X","X","X","X","X","X","X","X","X","2","0","0","0","0","0","0","0","0","0","0","0","4","0","0","0","0","0","0","0","0","0","0","0","0","0","0","0","0","0","0","0","0","0","0","4","4","0","0","0","X","X","X","X","0","0","0","0","X","X","X","X","X","X","0","0","0","0","0","0","0","0","0","0","0","3","0","0","0","0","0","0","X","X","X","X","X","0","0","0","0","0","0","0","0","0","0","5","0","0","0","0","4","4","4","0","0","0","0","0","0","0","0","0","0","4","X","X","X","X","X","X","X","X","X"],
["X","X","X","X","X","X","X","X","2","2","2","2","0","0","0","0","0","0","0","0","0","0","0","7","0","0","0","0","0","0","0","0","0","0","0","0","0","0","0","0","0","0","0","0","0","0","0","0","0","0","0","0","0","0","0","0","0","0","0","0","0","0","0","0","0","5","4","4","2","X","4","4","X","X","X","X","X","X","X","2","0","0","0","0","0","0","0","0","0","0","0","0","0","0","0","0","0","0","0","0","0","0","X","X","X","X","X","X","X","X","0","0","0","0","0","4","0","0","0","0","X","X","X","X","0","0","0","0","0","X","X","X","X","0","0","0","0","0","0","0","0","3","0","0","0","0","0","0","0","0","0","0","0","0","0","0","0","0","0","0","0","0","0","0","0","0","0","4","5","5","0","0","0","0","0","0","3","0","0","0","0","0","0","0","0","X","X","X","X","X","X","X","X","X","X"],
["X","X","X","X","X","X","X","X","0","0","0","0","0","0","0","0","0","0","0","0","0","0","0","0","0","0","0","0","0","0","0","0","0","0","0","0","0","0","0","0","0","0","2","0","0","0","0","0","0","0","0","0","0","0","0","0","0","0","0","0","0","0","0","0","0","0","4","4","2","0","0","0","0","0","0","0","0","0","0","0","0","0","0","0","0","0","0","0","0","2","0","0","0","0","0","0","0","0","0","0","0","0","X","X","X","X","X","X","X","X","0","0","0","0","0","0","0","0","0","3","X","X","X","X","0","0","0","0","0","0","0","0","0","0","0","0","0","0","0","0","0","0","0","0","0","0","0","0","0","0","0","0","0","0","0","0","0","0","0","0","0","0","0","0","0","0","0","0","0","0","0","0","0","0","0","0","0","0","0","0","0","0","0","0","0","0","X","X","X","X","X","X","X","X","X"],
["X","X","X","X","X","X","X","X","0","0","0","0","0","0","0","0","0","0","0","0","0","2","0","0","0","0","0","0","0","0","2","2","2","0","0","0","0","2","2","X","X","X","2","0","0","0","0","0","0","0","0","0","0","6","6","6","6","0","0","0","0","0","0","0","0","0","0","0","0","0","0","0","0","0","0","0","0","0","0","0","0","0","0","1","1","1","1","1","1","2","X","X","X","X","X","X","X","X","X","X","X","X","X","X","4","4","X","X","X","X","2","0","0","0","0","0","0","3","0","0","X","5","5","X","0","0","0","0","0","0","0","0","0","0","0","0","0","0","0","0","0","0","0","0","0","2","0","7","0","0","0","0","0","0","0","0","0","4","4","0","0","0","0","0","0","0","0","0","0","0","0","7","0","0","0","0","0","0","3","0","0","0","0","0","0","0","X","X","X","X","X","X","X","X","X"],
["X","X","X","X","X","X","X","X","2","2","2","2","0","0","2","2","2","2","2","2","2","2","1","1","1","X","X","X","X","X","X","X","X","0","0","0","0","X","X","X","X","X","X","6","6","6","6","6","6","6","6","6","6","X","X","X","X","0","0","0","0","0","0","0","0","0","0","0","0","0","0","0","6","6","6","6","6","6","6","6","6","6","6","X","X","X","X","X","X","X","X","X","X","X","X","X","X","X","X","X","4","4","4","4","4","4","4","4","4","2","2","0","0","0","0","0","0","0","0","0","X","5","5","X","2","2","2","0","0","0","0","0","0","0","0","0","0","0","2","2","2","2","2","2","2","2","2","X","0","0","0","0","0","0","0","0","0","2","4","0","0","0","0","0","0","0","0","0","4","0","0","2","2","0","0","0","0","0","0","0","0","0","0","0","0","0","X","X","X","X","X","X","X","X","X"],
["X","X","X","X","X","X","X","X","X","X","X","X","0","0","X","X","X","X","X","X","X","X","X","X","X","X","X","X","X","X","X","X","X","0","0","0","0","X","X","X","X","X","X","X","X","X","X","X","X","0","0","0","X","X","X","X","X","0","0","0","0","1","1","1","1","1","0","0","0","0","0","0","X","X","X","X","X","X","X","X","X","X","X","X","X","X","X","X","X","X","X","X","X","X","X","X","X","X","X","X","4","4","4","4","4","4","4","4","4","2","2","2","X","X","X","X","X","6","6","6","X","X","X","X","6","2","1","1","1","1","1","1","0","0","0","1","1","1","X","X","X","X","X","X","X","2","X","X","6","6","6","0","0","0","0","6","6","2","4","0","0","0","0","0","0","0","0","4","4","4","4","X","X","0","0","0","0","0","0","0","5","0","0","0","0","0","X","X","X","X","X","X","X","X","X"],
["X","X","X","X","X","X","X","X","X","X","X","X","0","0","X","X","X","X","X","X","X","X","X","X","X","X","X","X","X","X","X","X","X","0","0","0","0","X","X","X","X","X","X","X","X","X","X","X","X","0","0","0","X","X","X","X","X","1","1","1","1","X","X","X","X","X","X","X","X","4","4","4","X","X","X","X","X","X","X","X","X","X","X","X","X","X","X","X","X","X","X","X","X","X","X","X","X","X","X","X","4","4","4","4","4","4","4","4","4","4","X","X","X","X","X","X","X","X","X","X","X","X","X","X","X","X","X","X","X","X","X","X","0","0","0","X","X","X","X","X","X","X","X","X","X","X","X","X","X","X","X","0","0","0","0","X","X","X","4","4","4","4","4","4","4","4","4","4","4","X","X","X","X","X","X","X","X","X","X","X","X","X","X","X","X","X","X","X","X","X","X","X","X","X","X"]]}
